WWWWWWWWWWWWWWW
WWWWWWWWWWWWWWW
WWWWWWWWWWWWWWW
WWWWWWWWWWWWWWW
WWWWWWWWWWWWWWW
WWWWWWWGWWWWWWW
WWWWW  B  WWWWW
WWWWW B B WWWWW
WWWWWB B BWWWWW
WWWWW B B WWWWW
WWWWW  B  WWWWW
WWWWW     WWWWW
WWWWW  P  WWWWW
WWWWWWWWWWWWWWW