WWWWWWWWWWWWWWW
W      G      W
W      W      W
W             W
W             W
W      B      W
W             W
W  W   B   W  W
W             W
W             W
W      W      W
W             W
W             W
W      P      W
WWWWWWWWWWWWWWW